000000000000000000000000000
000000000000000000000000000
011100111001110011100000000
001000100001000001000000000
001000111001110001000000000
001000100000010001000000000
001000111001110001000000000
000000000000000000000000000
000000000000000000000000000
000000000000000000000000000
000000000000000000000000000
000000001000000000000000010
000000000000000000000000100
010000000010000111111000000
010000000010011111111000000
011110011101111111111001110
000000000000000000000000000
000000000000000000000000000