000000000000000000000000000
000000000000000000000000000
011100111001110011100000000
001000100001000001000000000
001000111001110001000000000
001000100000010001000000000
001000111001110001000000000
000000000000000000000000000
000000000000000000000000000
000000000000000000000000000
000000000000000000000A00000
000000001000000000000000010
000000000000000000000000100
0100000000100001111110000A0
01000000001BB11111111000000
011110011101111111111001110
000000000000000000000000000
000000000000000000000000000