000000000000000000000000000
00000000000A000000000000000
11111111111A110000000000000
00000000000A000000000000000
00000000000A000000000000000
000000000000000000000000000
000000000011111111111110000
00000A000000000000000000000
000000000000000000000000000
000000000000000000000000000
000010000000000000000000000
00001000B000000000000000000
0000101A1000000000000000000
0000100000000A0000000000000
0000111000000100000A0000000
0000000100100000000A0000000
00000000000000000000A000000
000000000000000000000000000