000000000000000000000000000
011100111001110011100000000
001000100001000001000000000
001000111001110001000000000
001000100000010001000000000
001000111001110001000000000
000000000000000000000000000
000000000000000000000000000
000000000000000000000000000
000000000000000000000000000
000000000000110000010000000
000000000000000000000000000
000100000000000000000000000
000000011000000000000000000
000000000000000111111000020
000000000000011111111000000
011110011111111111111001110
000000000000000000000000000