000000000000000000000000000
000000000000000000000000000
0000AA000000000001000000000
0000AA011111111101000000000
0000A000000000000BB00001100
0000A00000000A000BB00001000
0000000000000A0001100000000
000000000111110000000000000
000000000000000000000000000
000000100000000000000000000
000000001000000000000000000
000000000010A00000110000B00
000000000000100000000000110
0000000000000000000AA001000
00000000000000A000011000000
000000000000001000000000000
111111111110000000000000000
000000000000000000000000000